111111111111111
10C0010100001P1
100100010110101
101110010111101
101000010C00001
101111110101111                     1
100000000101001
111101111101001
101C01100001001
101001001001101
101111011000001
100000001010001
101011101011111
1E10000010C0001
111111111111111