1111111111
1000000001
1000P00001
1000000001
1000000001
100000E001
1111111111