1111111111111111111111111111
1000000000000000000000000001
1000C000000000001CCC00000001
1000000000000000000000000001
111000000000000000000P000001
1C10000000000000000000000001
1110000000000000C00000000001
10000E0000000000000000000001
1111111111111111111111111111