111111111111111111
1000000C0000001111
1000P0000001000011
111011100C00011001
11101E000000000011
11111111111111111