1111111111111
1000000000000
1000000000000
1000000000000
1000000000000
1000000000000