111111111111111
10C0010100001P1
100hhhh10110101
101110010111101
101000010C00001
1011w1110101111
100000000101001
111101111101001
101CG1100001001
101001001001101
101111011000001
1000000010b0001
101011101011111
1E10000010C0001
111111111111111