1111111111111111111
10000PC000000000E01
1111111111111111111