1111111111111111111111111111111111111111
1P0000000C000000000000000000000000000001
10000C0000000000000C00000000000C00000001
10000000000C0000000000C000000C0000000001
10C00000000C0000000000000C000000000C0001
100000000000000C0000000000C0000000000001
10000C000000000000000000C000000000000001
100000000C000000000C0000000000000C000001
100000000000000000000C000000000C00000001
100000000C000000000000C00000000000000001
100000000000000C000000000000C0000000C001
100000C0000C000000000C000000000C00000001
100000000000000C0000000000C0000000000001
10000C000000000000000000C0000000C0000001
100000000C000000000000C00000000000000001
100000000000000C000000000000C00000000001
100000000C000000000C0000000000000C000001
100000000000000000000C000000000C00000001
100000000C000000000000C00000000000000001
10000C0000000000C0000000C00000C0000E0001
1111111111111111111111111111111111111111