11111111111
1P111111001
10011111101
11C01111C01
11100110011
11110C00111
11111E01111
11111111111