1111111111111111
100P0C0C0C0C0C01
11111111111111C1
1C0C000C0C0C0C01
1111110101111111
1C0C0C0EC0C0C011
1111111111111111