111111111111111111111
100P00000000C00000001
111111111111111111101
100000000000000000101
101111111111111110101
101000000000000E10101
101011111111111110101
101000000000000000101
101111111111111111101
100000000000000000001
111111111111111111111