1111111111111111
10E001P0000000C1
1111111111111111
