111111111111111111
1000000000C0001111
100000000001111111
111111100C00011111
11111E000000000111
111111111111111111
