1111111111111111111111
1000000000000000000001
1000000P0000000C000001
1000000000000000000001
10000000000C0000000001
1000000000000000000001
1000CCCC00000000000001
1000000000000000000E01
1111111111111111111111