111111111111111111111
100P00000000000000001
111111111111111111101
1000000000C0000000001
101111111111111111111
1000000000000000000E1
111111111111111111111