11111111111111111111111
1P0000C0000000000000001
100C000000C000000C00001
100000C00000C000C000001
10C000C000000000000C001
10000000C00000C00000001
100C000000000C000000001
1000C00000C0000000C0001
10000000000C00000C00001
1000C0000000C0000000001
10000000C000000C0000001
100000C0000000000C00001
100C00000C000C00000E001
11111111111111111111111